'Fruit': Stardew Valley Artwork
AAAA: Pack of Duracell Batteries
ANIMAL WELL: Screenshot from ANIMAL WELL, modified by Kaito Kid with a Stardew Valley Rare Disc
ASMR: Custom ASMR lines provided by Allison (Jubilee Whispers) https://www.youtube.com/@JubileeWhispers. Icon from google images
Amon's Fall: Starcraft 2 Artwork
Anything for Beyonce: itsjustluke on Vine
Archipela-Go!: combo89 on Discord
ArgonMatrix: Images created by Spiniyo on Fiverr for ArgonMatrix
Automation: Factorio Artwork
Bad Farmer: Brawndo Logo from Idiocracy
Bad Fisherman: Stock image
Balls: Stock Image of a ball pit
Big Grapes: Anonymous
Blossom Garden: Image created by graphicblasterr on Fiverr then modified by SakuraTsubasa for the Blossom Garden
Bun-dle: Anonymous Recipe websites
Bundle Bundle: Modified Stardew Valley Screenshot
Burger King's Revenge: @Rythayze on Twitter
Burger King: Burger Ling Logo
Caffeinated: The Simpsons Screenshot
Cap: Captain Canadia Logo
Capitalist: Stardew Valley Screenshot
Catch And Release: Reigh Rubes Cartoons
Celeste: Celeste Artwork
Chaos Emerald: Modified Stardew Sprites from Jonfunk
Clickbait: Internet Meme
Clique Button: PreludeWish on Discord
Clique: thephar on Discord
Colored Crystals: Stardew Valley sprite
Commitment: Tinder Logo
Communism: Communism logo
Connection: Stock image modified by Kaito Kid with an Archipelago logo
Cookie Clicker: Cookie Clicker Artwork
Cooperation: Stock Image
Crab Rave: Stardew Valley Screenshot
Crap Pot: Recreationg of the poop emoji by Jonfunk
Crowfunding: Kickstarter Logo
Death: Stardew Valley Artwork
Deathlink Currency: Original work by Jonfunk
Deathlink: Modified Stardew Sprites from Jonfunk
Distracted: Internet meme
Doctor Angler: ArgonMatrix Thumbnail
Doctor: Stardew Valley sprites, organised by Kaito Kid
Dr Seuss: Cover from Dr Seuss book
Eg: Internet Meme
Emmalution: Emote from Emmalution's Discord Server
Exhaustion: Internet Meme
Fast: Internet Meme
Firstborn: Internet Meme
Flashbang: Handmade White Frame
FrazzleDuck: Image from Frazzleduck
Gacha: Paimon from Genshin Impact
Hairy: Frame from One Punch Man
Hats Off To You: Anonymous
Hibernation: Sleeping Pepe the Frog from unknown artist
Hint: Stock Image
Honeywell: Icon made by Honeywell
Honorable: Stardew Valley Combined Artwork
Humble: Humble Bundle Logo
Hurricane Tortilla: jakebieniewicz on Vine
IKEA: IKEA Logo
Investment: Stonks Meme
Joetg: Emote from Joetg's Discord Server
Journalist: Cuphead Tutorial Screenshot
Kent C.: Internet Meme
Legendairy: Legendairy Milk Logo
Lemonade Stand: Recreation of the duck from The Duck Song on youtube
Look At These Chickens: Vine
Loser Club: Image from ATwentySomethingLoser in their Loser Club community
Mermaid: Stardew Valley Screenshot
Minecraft: Minecraft Movie Screenshot
Ministry of Madness: Icon by Eponasong for the MoM Discord Server
NFT: lmao
Not The Bees: Bee Movie Screenshot
Obelisks: Age of Mythology Screenshot
Off Your Back: Clothes off my Back Logo
Permit A38: Asterix Screenshot
Pollution: Picture from the trash island
Pomnut: Image from TheRedWolfe based on Stardew Assets
Pool: Stock Image
Potato: Kaito Kid, made from Stardew Valley Artwork
Puzzle: Dynamically loads one of the other images
Reconnection: Stock image modified by Kaito Kid with an Archipelago logo
Restraint: Screenshot from Spongebob
Reverse: Modified Stardew Valley Screenshot
Rick: Rick and Morty Screenshot
Romance: Kaito Kid, made from Stardew Valley Artwork
SMAPI: SMAPI Logo
Sacrifice: Loading screen from DOOM 2016
Sappy: Anonymous
Schrodinger: Stock Photo
Screw You: Stock Photo
Sisyphus: Anonymous
Snitch: Recess Screenshot
Speedrunners: Speedrunners Logo
Square Hole: Screenshot from Alison Burke's TikTok, and Audio from brock1137's TikTok
Stanley: Stanley Parable Achievement Image
Sunmaid: Sunmaid Logo
The Floor Is Lava: Board Game Box
TheAlGoreRhythm: Profile picture from TheAlGoreRhythm, Drawn by OnionAxolotl
This Is Fine: Internet Meme
Tick Tock: Don't Hug Me; I'm Scared Screenshot
Tilesanity: Thumbnail from Captain Canadia
Trout: Stardew Valley Artwork
Vampire: Avengers: Infinity War Screenshot
Very Sticky: Icon from the Sticky Bundle modified by Kaito Kid
Vocaloid: Vocaloid Artwork
What The Rock Is Cooking: WWE Screenshot